       &     &      &   
------------------------
                        
       &        &      &
------------------------
   &                &   
------------------------
                       &
------------------------
------------------------
  &                  &  
------------------------
     SF                 