       &     &      &   
------------------------
------------------------
     &        &         
  &      &            & 
   &          &     &   
------------------------
------------------------
&        &       &      
------------------------
------------------------
  &    &    &  &     &  
                 SF     