F      &     &      &   
------------------------
------------------------
------------------------
  &      &            & 
   &          &     &   
------------------------
                        
   &        &       &   
                        
  &    &    &  &     &  
------------------------
                 S      