  && & & &   &      &  F
------------------------
------------------------
------------------------
  & & &&&&   &   &    & 
&  & &   &    &&&&&&&   
------------------------
------------------------
   &    &   & && & &  & 
& & &&&& &&&   &   &    
 &&    &    & && &&  &  
------------------------
 S  &&&&&&    &&&       