       &     &   F  &   
------------------------
------------------------
       &        &       
------------------------
   &          &     &   
                        
                        
------------------------
      &    &            
  &    &             &  
------------------------
     S                  