                        
------------------------
 S   &        &      &  
------------------------
         &            & 
   &       F        &   
------------------------
       &      &         
   &                &   
------------------------
       &       &     &  
------------------------
                        