                        
------------------------
 &   &        &      &  
------------------------
         &           &  
   &       F        &   
------------------------
       &      &         
   &       S        &   
------------------------
       &       &     &  
------------------------
                        