                        
------------------------
 &   &        &      &  
------------------------
         &           &  
   &        S      &     
------------------------
------------------------
   &               &    
       &       &     &  
------------------------
                        