F      &     &      &   
------------------------
 &   &        &      &  
------------------------
  &      &       S    & 
   &          &     &   
------------------------
                        
   &        &       &   
------------------------
  &    &    &  &     &  
------------------------
                        