        F               
------------------------
 &   &        &      &  
------------------------
         &           &  
   &                &   
------------------------
       &      &         
   &                &   
------------------------
    S  &       &     &  
------------------------
                        