F      &     &      &   
------------------------
 &   &        &      &  
------------------------
  &      &            & 
   &          &     &   
------------------------
                        
   &     S  &       &   
------------------------
  &    &    &  &     &  
------------------------
                        