                        
------------------------
 &   &        & F    &  
------------------------
         &           &  
 S &                &   
------------------------
       &      &         
   &                &   
------------------------
       &       &     &  
------------------------
                        