       & &   &      &  F
------------------------
 &   &  &     &      &  
------------------------
  &      &   &   &    & 
   &     &    &&&&&&&   
------------------------
------------------------
   &    &   &  &&   &   
  & && & &&&   &   &    
  &    &    &  &     &  
------------------------
S                       